111111111111111
1001000000000C1
100001111100001
1P0011E00000001
111111111111111